1111111111111111111111111111111
1010001000000000101000001000001
1010101111111010101010101010111
1000100010000010001010101010001
1111111010111011111010111011101
1000001010001010000010000010001
1011101011101110111111111110101
1000101000100000000000100000101
1010111110111111111110101111111
1010000000100010000000100000001
1011111111101011111111111111101
1010000000001000000000001000001
1011111111101011111111101011101
1000100000101010001000100010101
1110101110101110101010111110101
1010001000100010101010000000001
1011111011101010101011111111111
1010000010101000101010000010001
1010111110101111101011101010101
1010000010001000101000001000101
1011111010111010101111111111101
1000001010100010100010000010001
1011111010101110111011111010111
1000001010101010001010000010001
1011101011101011101010111111101
1010100010001000101010000000001
1010111110111110101010111111111
1000100000100000100010100000001
1110101111101011111110111110101
1000001000001000000000000000101
1111111111111111111111111111111
