1111111111111111111111111111111
1000101000000000100000000000001
1110101010111110101111111110101
1000100010101000100010000000101
1011111110101011111110111111101
1010000010100010000000100000101
1011101010101110111111111011101
1000001000101000101000000010001
1111111111101110101011101110111
1000001000001000101010100000001
1110101011111011101010111111111
1000101000100010001000000010001
1011111110101110101011111110101
1000000010100010100010000000101
1011111010101011101110111111101
1010001010101000100010000010001
1011101010101110111110111110101
1000001010100010000000100000101
1011111010111011111111101111111
1010000010101000100000100000001
1010111110101110101111101111101
1010000000101000001000100010001
1011111111101011111010111110101
1010000000001000100010000010101
1010111011111110101111111010101
1010100010001000101000001000101
1010111110101011101010101111101
1010000000100010001010100010001
1010111111111110111010111110111
1010000010000000100010100000101
1011111010111111111110101111101
1000001010001000000000101000001
1111101111101011101111101011101
1000101000001010100000001000101
1011101011111010111111111010101
1000001010001010000000001010101
1011111011101011101111101110101
1010001000101000101000100000101
1010101110101110101011111111101
1000100000100000001000000000001
1111111111111111111111111111111
