111111111111111111111
000000000000000000000
111111101011111110101
000000000000000000000
101110101010101110101
000000000000000000000
111110101011111011111
000000000000000000000
101111101111111010101
000000000000000000000
101010111111101011101
000000000000000000000
101110111111101110101
000000000000000000000
101011111111111111101
000000000000000000000
101111111010101111101
000000000000000000000
111010111111111010101
000000000000000000000
111111111111111111111
