111111111111111111111
101000000000100000001
101111111010101111101
100000100010001010001
111110101111111010111
100010100000101000101
101110111110101011101
100010100010101010001
111010101010101010111
100010101000100010001
101010101111101110101
101010001000100010101
101111111010111011101
100010000010000010001
111010111111111110111
100010000000100010001
101011111110101011101
101010000010101010001
101110101110101010101
100000100000001000101
111111111111111111111
