111111111111111111111
000000000000000000000
101011101110111110111
000000000000000000000
101110101111111011101
000000000000000000000
111010111010111110101
000000000000000000000
101111111010101011101
000000000000000000000
111111111110101110101
000000000000000000000
101110111111111110101
000000000000000000000
101111101110111110101
000000000000000000000
101011111011101011101
000000000000000000000
101110101111111010111
000000000000000000000
111111111111111111111
