11111111111
10000010001
11111010111
10100010001
10101111101
10100000101
10111110101
10000010101
10101110101
10100000001
11111111111
