1111111111111111111111111111111
1010001000100000000000100000001
1010101110101011111110101111101
1000100010001000100010100000101
1111111011101110111010101110101
1000001000100010001000100010101
1011101110111110101011111110101
1010000010100010101010000010101
1010111110101011101011101010101
1010100010001000001010001000101
1011101011111111111010111111101
1000101000000010000010001000101
1010101111111010111111101011101
1010001000000010000000001000001
1111111011111011111111111011111
1000000010001010000000001000001
1011111111101010111111101111101
1000100000100000100010001000101
1010101110101111111010111010101
1010001000101000001000001010101
1011111011101011101111101011101
1000101010001000101000101010001
1110101010111110101010101010111
1010001010001000100010100010001
1011101011101011111110111011101
1010001000101000100010001000101
1010111110111110101011101111101
1010100010100010101000001000001
1010101010101010101111111011111
1000001010001000100000000000001
1111111111111111111111111111111
