111111111111111111111111111111111111111111111111111
100010000010000000000000000000100000000000001000101
111010111010111111111111111110101110111111101010101
101010001010100000000000001010101010100010101010101
101011101010101111101111101010101010101010101010101
101000101010101000100000100010100010001010101010101
101110101110101010111110111010111011111010101010101
101000101000101010000000100010000010001010000010001
101011101011101011111111101111111110101010111111101
101000100010001000100000100010001000100010100000101
101110101111111110101111111010101011111111101110101
100010101000000000100010001000101010001000000010101
101110101110111111111010101111101010101011111110101
100010100010100010000010100010001010100010001000101
101010111010101010101110111010111010111110101011111
101000101010101000100010001000101010001000101000001
101111101010101111111011101111101011101110101111101
101000100010100000001000101000101000100000101010001
101110101110111111101110101010101110111111101010111
100010000000100000000010100010001000100000100010001
111011111111111111111010111111101011101110111011101
100010000000100000100010000000001000001010000000101
101110111110101110111111111111101111111011111111101
101000001010001000100000000000101000000000100000001
101011101011111011101111111110101011111111101111111
101000101000000000001000000010100010001000100000001
101111101111111111111011101110111110101010101111101
100000100000001000001010001000100000101010101000001
111110111011101011101010111011101111101010111011101
100010001000100010101010001010001010001010001000101
101011101111111010101011101010111010111011101010101
101000100000001000101010001010100000000010001010101
101111111111101111101010111010101111111110111010101
101000000000001000101010100010100000100010001010101
101011111111111010101010101110111111101011101110101
101000100000001010101010101000100000101010000000101
101110101110101010101011101010101110101011111111101
100010100010100010001010001010101000101000100000001
101010111110111111111010111110101011101110101111111
101010100000100000100010000010001000100010100010001
101010101111101010101111111011101110111010111011101
101010001010001010001000001000101010100010101010001
101111111010111011111010111110101010101110101010101
100010000010101010000010000010100010001000100010101
101010101110101010111111111010111111111011101110101
101010100010101010000010000010100010001010000000101
101010111010101011101110101110101010101011111111101
101010100010101000101000101000101000101000001000101
101010101110101011101011111011101111101111101010101
101000100000001000001000000000001000000000001010001
111111111111111111111111111111111111111111111111111
